Poradnik jak pisac mapy:
Nalezy stworzyc fragmenty mapy o wymiarach 16x9, ktore potem sa losowo generowane
w niekonczaca sie mape. Program sam domysla sie ktore fragmenty mapy polaczyc z 
innymi fragmentami mapy

0 - woda
1 - trawa
2 - dom

3 - \  dolne pochylenie
	 \

4 -  / dolne pochylenie
	/
	
5 -  / gorne pochylenie
	/

6 - \ gorne pochylenie
	 \

7 - droga
8 - lewa strona mostu
9 - prawa strona mostu


5/\6
3\/4

MAPA MA SIE ZACZYNAC NA "[BEGIN]" I KONCZYC NA "[END]". BEZ SPACJI NA KONCU!!!

NIE DOTYKAC 1 MAPY
[BEGIN]
1100000000000011
1100000000000011
1100000000000011
1100000000000012
1100000000000011
1100000000000011
2100000000000011
1100000000000011
1100000000000011
[END]
NIE DOTYKAC 1 MAPY

[BEGIN]
1111000000001111
1100000000000011
1100000000000012
1100000000000011
1100000000000011
1100000000000012
1100000000000011
1100000000000011
1100000000000011
[END]

[BEGIN]
1100000000000011
2100000000000011
1100000000000011
1100000000000011
1100000000000011
1100000000000011
1100000000000011
1100000000000011
1111000000001111
[END]

[BEGIN]
1100000000000011
1100000000000011
1111111001111111
7777777897777777
1111111001111111
1100000000000011
2100000000000011
1100000000000011
1100000000000011
[END]

[BEGIN]
1100000000000011
1100000000000021
1100000000000011
1100000000000011
1200000000000011
1100000000000011
1100000000000311
1140000000003111
1114000000031121
[END]

[BEGIN]
1114000000031121
1100000000003111
1100000000000311
1100000560000011
1100006116000011
1100000140000011
1100000000000011
1100000000000011
1111000000001111
[END]

[BEGIN]
1100000000000011
1100000000000011
1100000000000011
1100000000000012
1100000200000011
1100000000000011
2100000000000011
1100000000000011
1100000000000011
[END]