Poradnik jak pisac mapy:
Nalezy stworzyc fragmenty mapy o wymiarach 16x9, ktore potem sa losowo generowane
w niekonczaca sie mape. Program sam domysla sie ktore fragmenty mapy polaczyc z 
innymi fragmentami mapy

0 - woda
1 - trawa
2 - dom

3 - \  dolne pochylenie
	 \

4 -  / dolne pochylenie
	/
	
5 -  / gorne pochylenie
	/

6 - \ gorne pochylenie
	 \

7 - droga
8 - lewa strona mostu
9 - prawa strona mostu


5/\6
3\/4

MAPA MA SIE ZACZYNAC NA "[BEGIN]" I KONCZYC NA "[END]". BEZ SPACJI NA KONCU!!!

NIE DOTYKAC 1 MAPY
[BEGIN]
1100000000000011
1100000000000011
1100000000000011
1100000000000012
1100000000000011
1100000000000011
2100000000000011
1100000000000011
1100000000000011
[END]
NIE DOTYKAC 1 MAPY

[BEGIN]
1111000000001111
1100000000000011
1100000000000012
1100000000000011
1100000000000011
1100000000000012
1100000000000011
1100000000000011
1100000000000011
[END]

[BEGIN]
1100000000000011
2100000000000011
1100000000000011
1100000000000011
1100000000000011
1100000000000011
1100000000000011
1130000000000411
1111000000001111
[END]

[BEGIN]
1100000000000011
1100000000000011
1111111001111111
7777777897777777
1111111001111111
1100000000000011
2100000000000011
1100000000000011
1100000000000011
[END]

[BEGIN]
1100000000000011
1100000000000021
1100000000000011
1100000000000011
1200000000000011
1100000000000011
1100000000000011
1110000000000111
1111100000011121
[END]

[BEGIN]
1111100000011121
1150000000006111
1100000000000011
1121211001121211
7777777897777777
1100000000000011
1100000000000011
1130000000000411
1111000000001111
[END]

[BEGIN]
1100000000000011
1100000000000011
1100004130000011
1100006111100012
1100000111000011
1100004111300011
2100001111100011
1100000111000011
1100000111000011
[END]

[BEGIN]
1100000111000011
1100000110000011
1100004113000011
1100001111300012
1100006111100011
1100000615000011
2100000000000011
1100000000000011
1111100000011121
[END]

[BEGIN]
1100000000000011
1100000000000411
1100000000004111
1100000000041112
1100000000411111
1100000004111111
2100000041112111
1100000411111111
1100000111111111
[END]

[BEGIN]
1100000111111111
1100000611111111
1100000061121111
1100000006111112
1100000000612111
1100000000061111
2100000000006111
1100000000000611
1100000000000011
[END]

[BEGIN]
1100000000000011
1130000000000011
1113000000000011
1111300000000012
1111130000000011
1111113000000011
2111111300000011
1111111130000011
1111111110000011
[END]

[BEGIN]
1111111110000011
1211111150000011
1111121500000011
1111115000000012
1111150000000011
1111500000000011
2115000000000011
1150000000000011
1100000000000011
[END]

[BEGIN]
1100000000000011
1100000000000011
1100001111000011
1100001111100012
1100001111100011
1100001111100011
2100001111100011
1100001111000011
1100000111000011
[END]

[BEGIN]
1100000111000011
1100001111000011
1100001111000011
1100001111100012
1100001111100011
1100001111100011
2100001111000011
1100000111000011
1100001111000011
[END]

[BEGIN]
1100001111000011
1100001111000011
1100001111000011
1100011111100012
1100011111100011
1100001111000011
2100000111000011
1100000110000011
1100000000000011
[END]

// z jednej strony
[BEGIN]
1111000000001111
1150000000041111
1100000000411111
1100000004111112
1100000001111111
1100000001111111
2100000001111111
1100000001111111
1100000001111111
[END]

[BEGIN]
1100000001111111
1100000001111111
2100000001111111
1100000001111111
1100000001111111
1100000001111111
1100000001111211
1100000001111111
1100000001111111
[END]

[BEGIN]
1100000001111111
1100000001112111
1100000001111111
1100000001111111
1100000001111111
1100000006112111
1100000000611111
1130000000061111
1111000000001111
[END]

//z drugiej strony
[BEGIN]
1100000000000011
1113000000000012
1111300000000011
1111130000000011
1121113000000011
1111111000000011
1111111000000011
1111111000000011
1111111000000011
[END]

[BEGIN]
1111111000000011
1211111000000011
1111111000000011
1112111000000011
1111111000000012
1111111000000011
1111111000000011
2111111000000011
1111111000000011
[END]

[BEGIN]
1111111000000011
1111111000000011
1111211000000011
1111111000000011
1111111000000011
1111115000000011
2111150000000011
1111500000000411
1111000000001111
[END]
